X X X X X X X X X X 
X       X   X     X 
X   X X X   X   X X 
X   X   X   o o o E 
X   X       o X X X 
X o o o o S o o o E 
X o X         X X X 
X o X   X         X 
X o X   X   X   X X 
X E X X X X X X X X 

