X X X X X X X X X X X X X X X X X X X X X X X X X X X X X X 
X       X       X   X   X       X   X   X   X   X   X     X 
X X X   X X X   X   X   X   X X X   X   X   X   X   X   X X 
X               X           X   X           X   X   X     X 
X   X   X X X   X X X   X X X   X X X X X   X   X   X   X X 
X   X   X       X           X   X   X                     X 
X X X X X X X   X X X   X X X   X   X X X   X X X X X X X X 
X   X   X   X   X   X   X   X       X   X           X     X 
X   X   X   X   X   X   X   X   X X X   X   X   X X X   X X 
X   X           X   X   X                   X   X   X     X 
X   X X X X X   X   X   X X X X X   X X X X X X X   X   X X 
X   X       X               X           X   X   X   X     X 
X   X   X X X X X X X X X   X X X   X   X   X   X   X   X X 
X   X   X       X           X       X   X o o o o o o o o E 
X   X   X   X X X   X X X         X X X X o X X X X X   X X 
X                   X         S o   X o o o     X         X 
X X X X X X X   X   X   X X   o o X X o X X X X X X X X X X 
X   X           X   X   X     o o o o o                   X 
X   X X X X X   X   X X X X X o X X X   X X X   X X X   X X 
X               X       X     o X           X       X     X 
X X X   X   X   X   X X X X X o X X X   X   X   X   X   X X 
X       X   X   X   X     o o o     X   X   X   X   X     X 
X X X   X   X X X X X X X o X X X   X X X   X X X   X X X X 
X       X   X   X         o o o X       X       X   X     X 
X   X X X   X   X X X X X   X o X X X X X   X   X X X   X X 
X   X       X   X   X   X   X o X   X       X             X 
X X X   X   X   X   X   X X X o X   X   X X X X X X X   X X 
X       X   X         o o o o o     X               X     X 
X   X   X   X   X   X o X   X   X   X   X   X   X   X   X X 
X X X X X X X X X X X E X X X X X X X X X X X X X X X X X X 

